{
  "lines": [
    "..............................................................................",
    "..............................................................................",
    "........SSSS..................................................................",
    "......SSSSSSSS................................................................",
    ".....SSGGGGGGSS...............................................................",
    ".....SSGMMMMGSS................SSSSSSSS.......................................",
    ".....SSGGGGMGSS..............SSSSSSSSSSSS.....................................",
    "......SSSSGGGSS............SSSGGGGGGGGGGSSSS..................................",
    ".........SSSSS.............SGGGMMMMMMMMGGGGSS...............SSSSSS....X.......",
    "...........................SGMMMMMMMMMMMMMGGSS.............SSGGGGSSS..........",
    "...........................SGMMMMIIIIMMMMMGGGSSSSSSSSSSSSSSSGGMMGGGSS.........",
    "..........................SSGMMIIIIIIIIIMMGGGGGGGGGGGGGGGGGGGMMMMMGGSS........",
    "..........................SGGMMIIIIIIIIIMMMGGGGGGGGGGGGGGGGGGMMMMMGGSS........",
    ".S.......................SSGMMMIIIIIIIIIMMMGGGGGGGGGGGGGGGGGGMMMMMGGSS........",
    "...................SS....SGGMMMIIIIIIIIIMMMGGGGGGGGGGGGGGGGGGGGMGGGSS.........",
    "................SSSSSSS..SGGMMMIIIIIIIIIMMMGGGGGGGGGGGGGGGGGGGGGGGSS..........",
    ".SS.............SGGGGGS..SSGGMMIIIIIIIIIMMMGGGGGGGGSSSSSSSSSSSSSSSS...........",
    ".SSS............SGMMMGSS..SSGMMIIIIIIIIIMMGGSSSSSSSSS.........................",	
    "..SS...........SSGMMMGGS...SGMMMMIIIIIMMMMGSS.................................",
    "...............SSGMMMMGSS..SGMMMMMMMMMMMMMGS..................................",
    "...............SSGGGGGGSS..SGGGMMMMMMMMMGGGS..................................",
    ".SSSS...........SSSGGSSS...SSSGGGGGGGGGGGGSS..................SSSS............",
    ".SSSS............SSSSSS..SSSSSSSSSSSSSSSSSS.................SSSGGSSS..........",
    ".SSGSS..................SSGGGSS....SSSS.....................SGGGGGGSS.........",
    ".SSGSS.....S............SSGGGSS.............................SGMMMMGSS.........",
    ".SSGGSS...........SSSSS..SSSSS.............................SSGMMMMGSS.........",
    ".SSGGGSS......SSSSSGGGSS...................................SSGMMMMGS..........",
    ".SSSGSS......SSSSGGGGGGSS...................................SGGGMGGS..........",
    "...SSS.........SSSSSSSSS....................................SSSGGGSS..........",
    ".......SSSSS..................................................SSSSS...........",
    "......SSGGGSS................................................................."
  ]
}
