{
  "lines": [
    "WWWWWWWWWWWW",
    "WWWWGGGGWWWW",
    "WWGGGG2GGGWW",
    "WGGG1GGG3GGW",
    "WGGGGGGMGGGW",
    "WWGGGGGGGGGW",
    "WWWWWGGGGGWW",
    "WWWWWWWGWWWW"
  ]
}
